# MSU JPN 401 Article Vocab and Kanji
# Compiled in Anki format by Kenneth Hanson, Fall 2012
# Last updated 11/24/12
# Format: Item | Reading | Meaning | Card Tags
# To import in Anki, delete the line number column and export as a Unicode (UTF-8) tab-delimited text file
# Note: Kanji that aren't in the main vocab are listed last for each article
# Note: Anki will not import facts with "duplicate items" -- vocab that appear in multiple articles will only be imported once.


# Article 1
岐阜	ぎふ	Gifu prefecture	article1, vocab_opt
覚える	おぼ（える）	to learn; remember	article1, vocab_know, kanji_rw
走行	そうこう	＝走ること	article1, vocab_know
キロ		kilometer    1km = 0.6 miles	article1, vocab_know
男児	だんじ	＝男の子 ⇔ 女児（じょじ）	article1, vocab_know, kanji_r
祖父	そふ	neutral/humble term for おじいさん	article1, vocab_know, kanji_rw
軽乗用車	けいじょうようしゃ	light passenger car	article1, vocab_rec
自宅	じたく	one’s house	article1, vocab_know, kanji_r
離れる	はなれる	to be separated from; be distanced	article1, vocab_know
約	やく	approximately	article1, vocab_know, kanji_rw
警察	けいさつ	police	article1, vocab_know, kanji_r
保護する	ほご（する）	to protect; care	article1, vocab_know
AT車	オートマしゃ	＝オートマ車; automatic car	article1, vocab_rec
（警察）署	けいさつしょ	police station	article1, vocab_rec, kanji_r
まま		as it is; leave something on	article1, vocab_know
Xを動かす	うご（かす）	to move X (Tr.)  Cf. Xが動く (Intr.)	article1, vocab_know, kanji_rw
出発する	しゅっぱつ（する）	to depart	article1, vocab_know, kanji_rw
身長	しんちょう	height (person)	article1, vocab_know, kanji_r
Xを伸ばす	のばす	to extend X (Tr.)  Cf. Xが伸びる (Intr.)	article1, vocab_know, kanji_r
アクセル		accelerator	article1, vocab_opt
操作する	そうさ（する）	to operate; manipulate	article1, vocab_know, kanji_r
祖母	そぼ	neutral/humble term for おばあさん	article1, vocab_know, kanji_rw
Xを目指す	めざ（す）	to aim at	article1, vocab_know, kanji_rw
無人	むじん	＝人が誰もいないこと	article1, vocab_know, kanji_rw
通行人	つうこうにん	passer-by	article1, vocab_know, kanji_r
通報する	つうほう（する）	to report (to police, firefighters, etc.)	article1, vocab_know, kanji_r
駐車場	ちゅうしゃじょう	parking lot	article1, vocab_know, kanji_r
#
新聞	しんぶん	newspaper	article1, vocab_past, kanji_rw


# Article 2
進化する	しんか（する）	to advance	article2, vocab_know, kanji_rw
若者	わかもの	young people	article2, vocab_know, kanji_rw
確かに	たし（かに）	certainly	article2, vocab_know
年々	ねんねん	＝毎年; year by year 	article2, vocab_rec
便利な	べんり（な）	convenient	article2, vocab_know, kanji_r
生活様式	せいかつようしき	life style	article2, vocab_rec
店内	てんない	＝店の中	article2, vocab_know
設置する	せっち（する）	＝置く; place; establish; install	article2, vocab_opt
画面	がめん	screen	article2, vocab_know
Xに触れる	ふ（れる）	＝Xに触（さわ）る; to touch X	article2, vocab_know
航空券	こうくうけん	＝飛行機（ひこうき）のきっぷ	article2, vocab_rec
予約する	よやく（する）	to reserve; book	article2, vocab_know, kanji_rw
書籍	しょせき	＝本	article2, vocab_rec
購入する	こうにゅう（する）	＝買う	article2, vocab_rec
求人	きゅうじん	job offer	article2, vocab_rec, kanji_r
公共料金	こうきょうりょうきん	public utilities charge	article2, vocab_know
支払い	しはら（い）	＝払うこと; payment	article2, vocab_know
今や	いま（や）	＝今では; not in the past but now	article2, vocab_opt
わざわざ		to bother to do…	article2, vocab_know
預け入れ	あず（け）い（れ）	deposit	article2, vocab_rec
払い戻し	はら（い）もど（し）	withdraw	article2, vocab_rec
残高照会	ざんだかしょうかい	to check bank balance	article2, vocab_rec
振り込み	ふ（り）こ（み）	bank transfer	article2, vocab_rec
現金	げんきん	cash	article2, vocab_know, kanji_r
通販	つうはん	＝通信販売; mail order	article2, vocab_know, kanji_r
自宅	じたく	＝自分の家	article2, vocab_know
宅配便	たくはいびん	home delivery	article2, vocab_know
最先端	さいせんたん	leading edge; forefront	article2, vocab_opt
拠点	きょてん	base point; location	article2, vocab_opt
基本	きほん	foundation	article2, vocab_know
要望	ようぼう	demand; request	article2, vocab_know, kanji_rw
Xに応える	こた（える）	＝対応（たいおう）する; to respond to X	article2, vocab_know
きめ細かく	（きめ）こま（かく）	carefully and sensitively	article2, vocab_rec, kanji_rw
特徴	とくちょう	characteristics	article2, vocab_know, kanji_r
広報	こうほう	public relations	article2, vocab_opt
希望する	きぼう（する）	to desire; hope	article2, vocab_know
高齢者	こうれいしゃ	＝お年より; the elderly 	article2, vocab_know
夫婦	ふうふ	married couple	article2, vocab_know
共稼ぎ	ともかせ（ぎ）	husband and wife both working	article2, vocab_rec
実に	じつ（に）	＝本当に; indeed	article2, vocab_know
現在	げんざい	at present; now	article2, vocab_know, kanji_rw
会員	かいいん	member	article2, vocab_know
超える	こ（える）	exceed	article2, vocab_know, kanji_r
どうやら		It seems like	article2, vocab_know
総合	そうごう	comprehensive	article2, vocab_know, kanji_r
目覚ましい	めざ（ましい）	remarkable; impressive	article2, vocab_know
欲求	よっきゅう	(instinctive, physiological) desire	article2, vocab_rec
#
情報	じょうほう	information	article2, vocab_past, kanji_rw
荷物	にもつ	baggage, package	article2, vocab_past, kanji_rw
対応する	たいおうする	to respond to	article2, vocab_past, kanji_rw
選ぶ	えらぶ	to choose, select	article2, vocab_past, kanji_rw
探す	さがす	to search	article2, vocab_past, kanji_r
料金	りょうきん	fee, charge	article2, vocab_past, kanji_r
家庭	かてい	home, family	article2, vocab_past, kanji_r


# Article 3
地域	ちいき	area; region; local community	article3, vocab_know
活性化	かっせいか	activation	article3, vocab_rec
味方	みかた	fried; ally; supporter	article3, vocab_know
ゆるい		loose; lenient; slow	article3, vocab_know
擬人化	ぎじんか	personification	article3, vocab_rec
人格化	じんかくか	impersonation  (人格 personality)	article3, vocab_rec
Xが進行する	しんこう（する）	＝進む; X is in progress	article3, vocab_know
"# 体"	たい	counter for humanoid forms	article3, vocab_know
掲載する	けいさい（する）	＝本などに載（の）せること;  to run in an article 	article3, vocab_rec
Xを出版する	しゅっぱん（する）	to publish X	article3, vocab_know, kanji_r
着ぐるみ	き（ぐるみ）	stuffed-animal suit; character costume	article3, vocab_opt
発売する	はつばい（する）	to release for sale	article3, vocab_know, kanji_rw
Xが経過する	けいか（する）	＝経（た）つ; to pass (time)	article3, vocab_rec
順調な	じゅんちょう（な）	doing well; favorable	article3, vocab_rec
編集者	へんしゅうしゃ	editor	article3, vocab_know
ブーム		boom	article3, vocab_know
代表する	だいひょう（する）	to represent	article3, vocab_know, kanji_rw
いわゆる		so called; so to speak	article3, vocab_know
定着する	ていちゃく（する）	to be established; take root in	article3, vocab_know, kanji_r
企画	きかく	planning; project	article3, vocab_rec
きっかけ		trigger; starting cue	article3, vocab_know
地元	じもと	＝出身; one’s origin	article3, vocab_know
人形	にんぎょう	doll; puppet	article3, vocab_know
果たして	は（たして）	I wonder…	article3, vocab_know
不気味な	ぶきみ（な）	＝気持ち悪い; creepy	article3, vocab_know
受け入れる	う（け）い（れる）	to accept; receive well	article3, vocab_know
Xをかわいがる		to love ; be affectionate toward X	article3, vocab_know
観光	かんこう	sightseeing	article3, vocab_know, kanji_rw
PR	ピーアール	public relations; publicity	article3, vocab_know
大使	たいし	ambassador	article3, vocab_rec
登場する	とうじょう（する）	＝現れる; to appear	article3, vocab_know
販売	はんばい	＝売ること; sales	article3, vocab_know
Xに貢献する	こうけん（する）	to contribute to X	article3, vocab_know
効果	こうか	effect	article3, vocab_know, kanji_rw
算出する	さんしゅつ（する）	＝計算する; calculate	article3, vocab_opt
○○自身	じしん	oneself	article3, vocab_know
年賀状	ねんがじょう	New Year’s card	article3, vocab_know
招待状	しょうたいじょう	written invitation	article3, vocab_rec
Xが届く	とどく	X is delivered (Intr.); Cf. Xを届ける to deliver X (Tr.)	article3, vocab_know, kanji_rw
候補	こうほ	candidate	article3, vocab_know, kanji_r
Xが集合する	しゅうごう（する）	＝集まる; X is gathered 	article3, vocab_know
コラボ		collaboration	article3, vocab_opt
宣言する	せんげん（する）	declare; announce	article3, vocab_know, kanji_r
からみ		involvement (slang)　→からむ	article3, vocab_opt
話題になる	わだい（になる）	to be in the news; talked about	article3, vocab_know
まさに		certainly; exactly; indeed	article3, vocab_know
一挙手一投足	いっきょしゅいっとうそく	every move one makes	article3, vocab_opt
Xを追いかける	おいかける	to run after; chase X	article3, vocab_know
現状	げんじょう	present condition	article3, vocab_know
成功	せいこう	success	article3, vocab_know, kanji_rw
著作権	ちょさくけん	copyright	article3, vocab_rec
使用料	しようりょう	usage charge; fee	article3, vocab_know, kanji_r
Xを挙げる	あ（げる）	to give X (points or examples)	article3, vocab_know, kanji_r
中小企業	ちゅうしょうきぎょう	small to medium enterprises	article3, vocab_rec
容易な	ようい（な）	＝簡単な、やさしい	article3, vocab_know, kanji_r
Xに参入する	さんにゅう（する）	＝参加する; enter; join X	article3, vocab_rec
Xを促す	うなが（す）	encourage; prompt X	article3, vocab_know, kanji_r
Xにつながる		to be connected to X	article3, vocab_know
手法	しゅほう	＝方法	article3, vocab_opt
しばらく		for a while	article3, vocab_know
注目	ちゅうもく	attention	article3, vocab_know, kanji_r
#
経済	けいざい	economy	article3, vocab_past, kanji_rw
結果	けっか	result	article3, vocab_past, kanji_rw
無料	むりょう	＝ただ；free of charge	article3, vocab_past, kanji_rw


# Article 4
関西	かんさい	the Kansai region  (Osaka and vicinal prefectures)	article4, vocab_know, kanji_rw
独立	どくりつ	independence	article4, vocab_know, kanji_rw
リーグ		league	article4, vocab_know
指名する	しめい（する）	to nominate; designate	article4, vocab_opt, kanji_r
ナックル		knuckle ball	article4, vocab_opt
操る	あやつ（る）	＝操作する; to operate; have a good command of	article4, vocab_know
神奈川	かながわ	Kanagawa prefecture (south of Tokyo)	article4, vocab_rec
近畿	きんき	＝関西	article4, vocab_rec
開幕する	かいまく（する）	＝始まる　(lit. to open the curtain) ; to start a game, play, etc.	article4, vocab_opt
野球	やきゅう	baseball	article4, vocab_know, kanji_r
新人	しんじん	new face; new comer; rookie	article4, vocab_rec
選択する	せんたく（する）	＝選ぶ; to choose	article4, vocab_rec
投手	とうしゅ	pitcher	article4, vocab_know, kanji_rw
"# 位"	い	# -th place	article4, vocab_know, kanji_rw
受ける	う（ける）	to receive	article4, vocab_know, kanji_rw
転校する	てんこう（する）	＝違う学校に行くこと	article4, vocab_rec
入団する	にゅうだん（する）	to enroll (team)	article4, vocab_opt
意向	いこう	intention; idea	article4, vocab_opt
契約	けいやく	contract	article4, vocab_know
初めて	はじ（めて）	for the first time  Cf.　始めて	article4, vocab_know
選手	せんしゅ	player	article4, vocab_know, kanji_rw
記者会見	きしゃかいけん	press conference	article4, vocab_opt
活躍する	かつやく（する）	to flourish; play an active role	article4, vocab_rec
セ・リーグ		Central League	article4, vocab_opt
パ・リーグ		Pacific League	article4, vocab_opt
照れる	て（れる）	to be bashful	article4, vocab_know
身長	しんちょう	height (person)	article4, vocab_know
センチ		センチメートル; centimeter	article4, vocab_know
下手投げ	したてな（げ）	underhand throw	article4, vocab_opt
揺れる	ゆ（れる）	to sake; sway	article4, vocab_know
軟式	なんしき	soft-ball	article4, vocab_opt
部	ぶ	department (company); team (school)	article4, vocab_know
一塁手	いちるいしゅ	first baseman (baseball)	article4, vocab_opt
転向する	てんこう（する）	to shift; switch; convert	article4, vocab_opt
応募する	おうぼ（する）	to apply for	article4, vocab_know, kanji_r
"# 回"	かい	# times; # inning (baseball)	article4, vocab_know
安打	あんだ	safe hit (baseball)	article4, vocab_opt
抑える	おさ（える）	to hold something down; suppress	article4, vocab_opt
元	もと	former   e.g. 元彼、元妻、元教師	article4, vocab_know
監督	かんとく	director (sport team, movie, etc.)	article4, vocab_know
話題性	わだいせい	topicality; possibility to be news	article4, vocab_opt
戦後	せんご	after war (especially WWII)	article4, vocab_know, kanji_rw
開く	ひらく	to hold (league, event), open (store) ; Cf. ドアが開（あ）く 	article4, vocab_know, kanji_rw
"# 割"	わり	# times 10%	article4, vocab_know
壁	かべ	wall	article4, vocab_know
記録	きろく	record	article4, vocab_know, kanji_r
程度	ていど	＝ぐらい、くらい	article4, vocab_know, kanji_r
原因	げんいん	cause; origin	article4, vocab_know, kanji_rw
体質	たいしつ	physical; genetic make-up	article4, vocab_opt
基づく	もと（づく）	to be based on	article4, vocab_know
一般に	いっぱん（に）	generally speaking	article4, vocab_know, kanji_r
柔軟性	じゅうなんせい	flexibility	article4, vocab_opt, kanji_r
疲労耐性	ひろうたいせい	tolerance; resistance to exhaustion	article4, vocab_opt
傾向	けいこう	tendency; inclination	article4, vocab_know, kanji_r
示す	しめ（す）	to show; indicate	article4, vocab_know, kanji_r
筋肉	きんにく	muscle	article4, vocab_know
量	りょう	amount	article4, vocab_know, kanji_r
(Xに) 劣る	おと（る）	to be inferior to X	article4, vocab_rec
投げる	な（げる）	to throw	article4, vocab_know
速さ	はや（さ）	speed  → 速い fast      Cf. 早い early  	article4, vocab_know, kanji_rw
おそらく		＝たぶん; probably	article4, vocab_know


# Article 5
米	アメリカ	米国（べいこく）	article5, vocab_know
#壁	かべ	wall	article5, vocab_know
足る	た（る）	＝足りる; to be sufficient; enough	article5, vocab_know
暮らす	く（らす）	＝生活する; 住む	article5, vocab_know, kanji_r
認める	みと（める）	to approve; to admit	article5, vocab_know, kanji_rw
権利	けんり	right	article5, vocab_know, kanji_rw
防衛	ぼうえい	defense	article5, vocab_rec
限定する	げんてい（する）	to limit	article5, vocab_know, kanji_r
滞在する	たいざい（する）	to stay	article5, vocab_know, kanji_r
配偶者	はいぐうしゃ	spouse	article5, vocab_know
発給する	はっきゅう（する）	to issue (visas)	article5, vocab_opt
拒む	こば（む）	＝拒否（きょひ）する; to refuse	article5, vocab_know
Xとともに		＝Xと一緒に	article5, vocab_know
違憲性	いけんせい	unconstitutionality	article5, vocab_rec
主張する	しゅちょう（する）	to argue; to claim; to insist;	article5, vocab_know, kanji_r
訴訟	そしょう	lawsuit	article5, vocab_know
原告	げんこく	plaintiff	article5, vocab_rec
渡米する	とべい（する）	＝アメリカに行く	article5, vocab_rec
ほんのN		mere; only; just	article5, vocab_know
(お) 互いに	（お）たがい（に）	each other; one another	article5, vocab_know, kanji_rw
印象	いんしょう	impression	article5, vocab_know, kanji_rw
文通	ぶんつう	exchange of letters	article5, vocab_know
転機	てんき	turning point	article5, vocab_know
どきどき		thumping heart	article5, vocab_know
決心する	けっしん（する）	＝決める; to decide	article5, vocab_know, kanji_rw
翌年	よくねん、よくとし	following year	article5, vocab_know
転がり込む	ころ（がり）こ（む）	to move in with (as an unexpected guest); to roll in (to a bed)	article5, vocab_rec
囲む	かこ（む）	to surround	article5, vocab_know, kanji_r
誓う	ちか（う）	to take a vow; to pledge	article5, vocab_know
ようやく		at long last	article5, vocab_know
かご		cage	article5, vocab_know
次第に	しだい（に）	gradually (progress into a state)	article5, vocab_know, kanji_r
取得する	しゅとく（する）	＝得（え）る; to obtain; to acquire	article5, vocab_know, kanji_r
いずれのN		either/neither of N; all/none of N	article5, vocab_know
永住	えいじゅう	permanent residence	article5, vocab_know
保障する	ほしょう（する）	to guarantee	article5, vocab_know
万策尽きる	ばんさくつ（きる）	to run out of options	article5, vocab_opt
支援団体	しえんだんたい	support groups; lobbying organization	article5, vocab_rec
きっかけ		start; cue; trigger	article5, vocab_know
正式にV	せいしき（に）	formally	article5, vocab_know, kanji_rw
提訴する	ていそ（する）	to file a suit	article5, vocab_opt
踏み切る	ふ（み）き（る）	to take a risky, bold step	article5, vocab_rec
通知	つうち	notice	article5, vocab_know
考慮する	こうりょ（する）	＝考える	article5, vocab_rec
許可	きょか	permit	article5, vocab_know, kanji_r
一歩を踏み出す	いっぽ（を）ふ（み）だ（す）	to take a step forward	article5, vocab_know
励み	はげ（み）	encouragement	article5, vocab_rec
怖い	こわ（い）	to be scared	article5, vocab_know, kanji_r
正直	しょうじき	honesty	article5, vocab_know, kanji_rw
頑張る	がんば（る）	to do one’s best	article5, vocab_know
#
再会	さいかい	meeting again, reunion	article5, vocab_know, kanji_rw
困難	こんなん	difficulty, distress	article5, vocab_know, kanji_rw
求める	もとめる	to request, demand	article5, vocab_past, kanji_rw
退去	たいきょ	departure, going away	article5, vocab_know, kanji_r


# Article 6
河合雅司	かわいまさし	産経新聞の論説委員（ろんせついいん editorialist）	article6, vocab_opt
少子化	しょうしか	＝子供の数が少なくなること	article6, vocab_know
顔を背ける	かお (を) そむ (ける)	to turn away; look away	article6, vocab_know
鳩山政権	はとやませいけん	Hatoyama administration (9/16/09-6/8/10)	article6, vocab_opt
むろん		＝もちろん	article6, vocab_opt
出産	しゅっさん	＝子供を産むこと; childbirth, 	article6, vocab_know, kanji_rw
同様に	どうよう（に）	＝同じように	article6, vocab_rec, kanji_rw
意思	いし	decision; will	article6, vocab_know
選択肢	せんたくし	options	article6, vocab_know
いずれ		＝いつか	article6, vocab_rec
まさに		＝本当に	article6, vocab_rec
未婚化	みこんか	＝結婚しない人が増えること	article6, vocab_opt
晩婚化	ばんこんか	＝遅く結婚する人が増えること	article6, vocab_opt
危機	きき	danger; crisis	article6, vocab_know, kanji_r
出会い	であ（い）	meeting	article6, vocab_know
対応	たいおう	response	article6, vocab_know
切迫感	せっぱくかん	a sense of urgency	article6, vocab_opt
希薄（な）	きはく（な）	rarefied; reduced; weak	article6, vocab_opt
かつて		＝前、昔	article6, vocab_rec
地域	ちいき	neighborhood; community	article6, vocab_know, kanji_r
世話焼きをする	せわやき（をする）	＝世話を焼く、世話をする	article6, vocab_know
皆婚	かいこん	＝皆が結婚すること	article6, vocab_know
婚活	こんかつ	＝結婚活動; spouse hunting	article6, vocab_know
盛ん（な）	さか（んな）	＝人気がある; popular	article6, vocab_know
構造	こうぞう	structure	article6, vocab_know
十分（な）	じゅうぶん（な）	sufficient; adequate	article6, vocab_know
認識する	にんしき（する）	to be aware; recognize	article6, vocab_know, kanji_r
配慮する	はいりょ（する）	consider; forethought, concern	article6, vocab_know
場	ば	＝場所、場面	article6, vocab_rec
(Xを)  増やす	ふやす	to increase X	article6, vocab_know, kanji_rw
深刻（な）	しんこく（な）	serious	article6, vocab_rec
雇用	こよう	employment	article6, vocab_know
不安定（な）	ふあんてい	instable; insecure	article6, vocab_know, kanji_r
(Xに)  追われる	お（われる）	to be chased by X; to struggle with X	article6, vocab_know
就職氷河期	しゅうしょくひょうがき	The Ice Age of employment (1991-2005 after the collapse of bubble economy; 2008-ongoing)	article6, vocab_opt
(Xと) 重なる	かさなる	to overlap; crossover with X	article6, vocab_know
団塊ジュニア世代	だんかいジュニアせだい	generation of baby-boomer’s juniors born between 1971-1974	article6, vocab_opt
今だ	いま（だ）	＝今でも	article6, vocab_rec
環境	かんきょう	environment; situation	article6, vocab_know, kanji_r
置く	おく	to put; place	article6, vocab_know, kanji_rw
夫婦	ふうふ	married couple	article6, vocab_know, kanji_r
非X	ひ	negative prefix; not X	article6, vocab_know
正規	せいき	official; full-time	article6, vocab_rec
予想する	よそう（する）	to predict; anticipate; forecast;	article6, vocab_know, kanji_rw
給与	きゅうよ	＝給料	article6, vocab_rec
水準	すいじゅん	standard	article6, vocab_know
下がる	さ（がる）	to decrease	article6, vocab_know
共働き	ともばたら（き）	two-incomes; double-earner	article6, vocab_know
保育	ほいく	childcare	article6, vocab_know, kanji_rw
拡充する	かくじゅう（する）	to expand; improve	article6, vocab_rec
(XをYに) 預ける	あず（ける）	to leave something (X) to someone (Y) for a while	article6, vocab_know, kanji_r
急速に	きゅうそくに	rapidly; at high speed	article6, vocab_know
(Xが)  減る	へ（る）	X decreases (Intr.)	article6, vocab_know, kanji_rw
歯止めをかける	はど（め）をかける	＝止める; to stop; halt	article6, vocab_rec
#
個人	こじん	individual	article6, vocab_old, kanji_rw
増える	ふえる	to increase (vi)	article6, vocab_old, kanji_rw
残す	のこす	to leave behind (vt)	article6, vocab_old, kanji_rw
選択	せんたく	choice, option	article6, vocab_know, kanji_r
政府	せいふ	government	article6, vocab_old, kanji_r
下がる	さがる	to go down	article6, vocab_old, kanji_r


# Article 7
原爆	げんばく	＝原子力爆弾（げんしりょくばくだん）; atomic bomb	article7, vocab_know, kanji_r
ボタン		button	article7, vocab_know
縁	えん	#NAME?	article7, vocab_know, kanji_rw
語る	かた（る）	＝話す	article7, vocab_rec
母校	ぼこう	＝卒業した学校; 出身の学校	article7, vocab_rec
慰霊	いれい	to comfort the sprit of the dead	article7, vocab_opt
Xに出席する	しゅっせき（する）	to attend X; participate in X	article7, vocab_know, kanji_r
生徒	せいと	＝学生（小学生～高校生）	article7, vocab_opt
遺族	いぞく	bereaved family	article7, vocab_opt
Xを詰まらせる	つ（まらせる）	to choke X (Tr.) Cf. Xが詰まる (Intr.)	article7, vocab_know
たまたま		accidentally; by chance	article7, vocab_know
救う	すく（う）	to save (a life); help	article7, vocab_know, kanji_r
投下	とうか	to throw down; drop	article7, vocab_opt
前身	ぜんしん	predecessor organization	article7, vocab_opt
爆心地	ばくしんち	center of explosion	article7, vocab_opt
疎開	そかい	dispersal; evacuation;	article7, vocab_opt
Xに取りかかる	と（り）かかる	＝し始める; to begin; set about	article7, vocab_opt
点呼	てんこ	roll call	article7, vocab_opt
直前	ちょくぜん	＝すぐ前; immediately before	article7, vocab_know, kanji_rw
陶器	とうき	pottery; ceramics	article7, vocab_rec
X製	せい	made by X; made in X	article7, vocab_know, kanji_r
天皇陛下	てんのうへいか	the Emperor	article7, vocab_rec
預かる	あず（かる）	to keep something for a meanwhile Cf. 預ける to leave for a meanwhile	article7, vocab_know, kanji_r
教官	きょうかん	＝先生	article7, vocab_opt
殴る	なぐ（る）	to hit	article7, vocab_know
縫う	ぬ（う）	to sew; stitch	article7, vocab_know
防空壕	ぼうくうごう	bomb shelter	article7, vocab_opt
瞬間	しゅんかん	moment	article7,
閃光	せんこう	＝光	article7, vocab_opt
気を失う	き（を）うしな（う）	to lose consciousness	article7, vocab_know, kanji_rw
当時の	とうじ（の）	＝その時の	article7, vocab_know
若干の	じゃっかん（の）	＝少しの	article7, vocab_opt
Xを欠席する	けっせき（する）	to be absent from X	article7, vocab_know, kanji_r
Xを除き	のぞ（き）	＝X以外は	article7, vocab_rec
犠牲になる	ぎせい（になる）	to be victimized; sacrificed	article7, vocab_know, kanji_r
記す	しる（す）	＝書く	article7, vocab_opt
中旬	ちゅうじゅん	middle (of a month)	article7, vocab_rec
見覚えのある	みおぼ（え）	＝前に見たことがある	article7, vocab_rec
紋章	もんしょう	crest; coat of arms	article7, vocab_opt
似島	にのしま	広島県にある島の名前	article7, vocab_opt
発掘	はっくつ	excavation	article7, vocab_opt
遺品	いひん	article of the deceased	article7, vocab_opt
級友	きゅうゆう	classmate	article7, vocab_know, kanji_r
身につける	み（につける）	＝体につける; to put on; wear	article7, vocab_know
土	つち	soil	article7, vocab_know
ほっておく		to leave alone	article7, vocab_know
碑	ひ	stone monument	article7, vocab_opt
教頭	きょうとう	vice principal; head teacher	article7, vocab_opt
証言する	しょうげん（する）	to give testimony	article7, vocab_opt
迷う	まよ（う）	to hesitate; wander; get lost	article7, vocab_know, kanji_rw
被爆する	ひばく（する）	to suffer from bombing	article7, vocab_know
仲間	なかま	circle of friends or colleagues	article7, vocab_know, kanji_rw
様子	ようす	state; appearance	article7, vocab_know, kanji_r
背	せ	＝背中（せなか）; back	article7, vocab_know
押す	お（す）	to push ⇔ 引（ひ）く to pull	article7, vocab_know
Xに臨む	のぞ（む）	to attend; approach	article7, vocab_opt
#
建物	たてもの	building	article7, vocab_old, kanji_rw
制服	せいふく	uniform	article7, vocab_know, kanji_rw
直す	なおす	to fix	article7, vocab_old, kanji_rw
訪れる	おとずれる	to visit （＝訪ねる）	article7, vocab_old, kanji_rw
頼む	たのむ	to request	article7, vocab_old, kanji_rw
除く	のぞく	to remove, exclude	article7, vocab_recog, kanji_r


# Article 8
自治体	じちたい	local town; municipality	article8, vocab_know
(Xが) 割れる	われる (Intr.)	X breaks; X splits up  Cf. (Xを) 割る	article8, vocab_know
脱X	だつ	de- (indicating reversal, removal, etc.)	article8, vocab_know
原発	げんぱつ	原子力発電所（げんしりょくはつでんしょ）nuclear power station	article8, vocab_know
再興	さいこう	reconstruction; 復興（ふっこう）; 再建（さいけん）	article8, vocab_opt
電力	でんりょく	electric power	article8, vocab_know
行方	ゆくえ	course; direction; whereabouts	article8, vocab_rec
稼動	かどう	operation (of machine; unit)	article8, vocab_opt
幹部	かんぶ	executive staff	article8, vocab_rec
訴える	うったえる	to bring to (someone's attention); to appeal to; to call for	article8, vocab_know
震災	しんさい	earthquake disaster	article8, vocab_know
被災する	ひさいする	to become a victim of some disaster	article8, vocab_know
仮（の）N	かり	temporary; interim; fictitious; assumed	article8, vocab_know
役場	やくば	town hall; 役所	article8, vocab_know
受ける	うける	1) to receive; 2) to face; as a result of	article8, vocab_know
(Xを) 進める	すすめる (Tr.)	to advance X; to promote X  Cf. (Xが) 進む	article8, vocab_know
足並みがそろう	あしなみがそろう	to keep pace; to reach an agreement	article8, vocab_rec
億	おく	100,000,000; hundred million	article8, vocab_know, kanji_rw
交付金	こうふきん	subsidy; grant; bounty	article8, vocab_opt
雇用	こよう	employment (full-time for a long term)	article8, vocab_rec
恩恵	おんけい	favor; blessing; benefit	article8, vocab_opt
もたらす		to bring about	article8, vocab_rec
廃炉	はいろ	decommissioning a nuclear reactor	article8, vocab_opt
周辺	しゅうへん	around; in the area of; in the vicinity of	article8, vocab_know, kanji_r
税収	ぜいしゅう	税金収入; tax revenue	article8, vocab_know
大幅に	おおはばに	大きく	article8, vocab_know
インフラ		infrastructure	article8, vocab_know
財源	ざいげん	source of funds	article8, vocab_know, kanji_r
明確に	めいかくに	clearly	article8, vocab_know, kanji_rw
かじを切る	かじをきる	to turn the rudder of a ship; to change direction (of policy, etc.)	article8, vocab_rec
"# 弱"	じゃく	little less than; fewer than; under	article8, vocab_know
Ｘに当たる	Ｘにあたる	1) to be hit by X; 2) to be equivalent to X	article8, vocab_know
避難する	ひなんする	to take refuge; evacuate; escape	article8, vocab_know
被害	ひがい	damage	article8, vocab_know, kanji_r
与える	あたえる	to give (esp. to someone of lower status)	article8, vocab_know, kanji_rw
今さら	いまさら	now (after such a long time); at this late hour (i.e. it is too late for something)	article8, vocab_know
強調する	きょうちょうする	to emphasize	article8, vocab_know, kanji_rw
X年度	ねんど	fiscal year (usually 4月～3月)	article8, vocab_know
辞退する	じたいする	to decline; refuse; not to accept	article8, vocab_rec
検討する	けんとうする	to consider	article8, vocab_know
(Xが) 広がる	ひろがる (Intr.)	X spreads  Cf. (Xを) 広げる (Tr.)	article8, vocab_know
可能性	かのうせい	possibility	article8, vocab_know
(Xが) 整う	ととのう(Intr.)	X is prepared; in order  Cf. (Xを) 整える 	article8, vocab_know
定期検査	ていきけんさ	periodic inspection	article8, vocab_know
見舞う	みまう	1) to visit someone sick; 2) to suffer hardship	article8, vocab_know
損傷	そんしょう	damage; injury of things	article8, vocab_rec
非常用	ひじょうよう	for emergency use	article8, vocab_know
電源	でんげん	source of electricity; electrical power	article8, vocab_know
増設する	ぞうせつする	to extend; expand	article8, vocab_rec
安全	あんぜん	safety	article8, vocab_know
対策	たいさく	counter-plan; counter-measure	article8, vocab_know
再開	さいかい	reopening; resumption; restarting	article8, vocab_know, kanji_rw
ゴーサイン		“go-sign;” green light; permission	article8, vocab_know
発電量	はつでんりょう	generated electricity	article8, vocab_know
Ｘに応じて	Ｘにおうじて	in proportion to X; according to X	article8, vocab_know, kanji_rw
金額	きんがく	amount of money	article8, vocab_know, kanji_r
仕組み	しくみ	structure; system; contrivance	article8, vocab_know
見込み	みこみ	expectation; anticipation; estimate	article8, vocab_know
風評	ふうひょう	rumor; gossip	article8, vocab_opt
含める	ふくめる	to include	article8, vocab_know, kanji_r
範囲	はんい	extent; scope; sphere; range	article8, vocab_know
(Xが) 及ぶ	およぶ (Intr.)	X reaches; X amounts to  Cf. (Xを) 及ぼす	article8, vocab_know
共存する	きょうぞんする	to co-exist	article8, vocab_know, kanji_rw
形成する	けいせいする	to form; to build	article8, vocab_rec
作業	さぎょう	work	article8, vocab_know, kanji_rw
欠かす	かかす	to miss; to fail	article8, vocab_know, kanji_r
#
証明	しょうめい	proof	article8, vocab_know, kanji_rw
住民	じゅうみん	resident	article8, vocab_old, kanji_rw
事故	じこ	accident	article8, vocab_old, kanji_r
人口	じんこう	population	article8, vocab_old, kanji_r
準備	じゅんび	preparation	article8, vocab_old, kanji_r
非常	ひじょう	extreme	article8, vocab_old, kanji_r


# Article 9
超	ちょう	super-; ultra-; very	article9, vocab_know
高齢化	こうれいか	aging	article9, vocab_know
敬老の日	けいろう（の）ひ	Respect the Elderly Day（9月の第3月曜日）	article9, vocab_opt
Xを迎える	むか（える）	to go out to meet X (person); X (time) approaches	article9, vocab_know
総務省	そうむしょう	Ministry of Internal Affairs	article9, vocab_opt
数値	すうち	＝数（かず）; numerical value	article9, vocab_rec
総人口	そうじんこう	total population	article9, vocab_rec
超える	こ（える）	to exceed; go over	article9, vocab_know, kanji_rw
本格的	ほんかくてき	full-scale; serious; real	article9, vocab_know, kanji_rw
到来する	とうらい（する）	＝来る (time/event)	article9, vocab_rec
占める	し（める）	to comprise (some part of the whole); account for; make up of	article9, vocab_know
たったNだけ		＝ただNだけ	article9, vocab_know
老人	ろうじん	＝お年寄り（おとしより）	article9, vocab_know, kanji_rw
保健	ほけん	health	article9, vocab_opt
施設	しせつ	institution; facility	article9, vocab_rec
福祉	ふくし	welfare	article9, vocab_rec
集団	しゅうだん	group	article9, vocab_rec
内容	ないよう	content	article9, vocab_know, kanji_rw
リハビリ		rehabilitation	article9, vocab_rec
介助	かいじょ	help; assistance (of a patient)	article9, vocab_opt
補助	ほじょ	help; assistance; support; auxiliary	article9, vocab_opt
作業	さぎょう	work; operation	article9, vocab_opt
療法	りょうほう	medical treatment	article9, vocab_opt
体操	たいそう	exercise; calisthenics	article9, vocab_rec
貼り絵	は（り）え	collage	article9, vocab_know
声を掛ける	こえ（を）か（ける）	＝話しかける ; to speak to	article9, vocab_know
雰囲気	ふんいき	atmosphere	article9, vocab_know, kanji_r
意識	いしき	consciousness; awareness	article9, vocab_know, kanji_r
寝たきり	ね（たきり）	bedridden; confined to bed	article9, vocab_know, kanji_rw
痴呆症	ちほうしょう	dementia	article9, vocab_opt
最低限	さいていげん	minimum	article9, vocab_know
意志	いし	will; volition	article9, vocab_rec
周囲	しゅうい	＝周（まわ）り; surroundings	article9, vocab_know
介護	かいご	nursing; taking care of a patient	article9, vocab_rec
老い	お（い）	aging  → 老いる to age (verb)	article9, vocab_know
与える	あた（える）	＝あげる	article9, vocab_know
状態	じょうたい	condition	article9, vocab_know, kanji_rw
話題	わだい	topic	article9, vocab_know, kanji_rw
勇気付ける	ゆうきづ（ける）	to encourage	article9, vocab_know
Xに慣れる	な（れる）	to be accustomed to	article9, vocab_know, kanji_r
偏見	へんけん	prejudice	article9, vocab_know, kanji_r
直す	なお（す）	to correct; fix	article9, vocab_know, kanji_r
感覚	かんかく	sense; sensation; feeling	article9, vocab_know
鈍い	にぶ（い）	dull; slow ⇔ 鋭（するど）い sharp; acute	article9, vocab_know
揃える	そろ（える）	to put things in order	article9, vocab_know
一瞬	いっしゅん	＝瞬間（しゅんかん）; moment	article9, vocab_rec
拍手	はくしゅ	applause	article9, vocab_know
近寄る	ちかよ（る）	＝近くに行くこと	article9, vocab_rec
#
現実	げんじつ	reality	article9, vocab_know, kanji_rw
意味	いみ	meaning	article9, vocab_old, kanji_rw
一緒に	いっしょに	together	article9, vocab_old, kanji_rw
高齢者	こうれいしゃ	old people （＝お年寄り）	article9, vocab_old, kanji_r
驚く	おどろく	to be surprised	article9, vocab_old, kanji_r
頑張る	がんばる	to do one's best	article9, vocab_old, kanji_r
習慣	しゅうかん	custom, habit	article9, vocab_old, kanji_r
嬉しい	うれしい	happy	article9, vocab_old, kanji_r
