# MSU JPN 401 Manga "Seiji" Vocab and Kanji
# Compiled in Anki format by Kenneth Hanson, Fall 2012
# Last updated 11/9/12
# Format: Item | Reading | Meaning | Card Tags
# To import in Anki, export as a Unicode (UTF-8) tab-delimited text file
# Note: Kanji that aren't in the main vocab are listed last for each article
# Note: Anki will not import facts with "duplicate items" -- vocab that appear in multiple articles will only be imported once.

国会	こっかい	National Diet	manga, vocab_know, kanji_rw
本物	ほんもの	＝本当のもの; real, genuine thing	manga, vocab_opt
それにしても		nevertheless	manga, vocab_opt
ビシッと		cleanly; smartly	manga, vocab_opt
左右対称	さゆうたいしょう	symmetrical	manga, vocab_opt
内部	ないぶ	＝中の: inside	manga, vocab_opt
構造	こうぞう	structure	manga, vocab_opt
衆議院	しゅうぎいん	Lower House; House of Representatives	manga, vocab_opt
参議院	さんぎいん	Upper House;House of Councilors	manga, vocab_opt
二院制	にいんせい	bicameral system	manga, vocab_opt
一致する	いっち	＝合う; agree; match	manga, vocab_opt
決定	けってい	decision	manga, vocab_know, kanji_rw
基本の	きほん	base; foundation	manga, vocab_opt
原則	げんそく	principal; rule	manga, vocab_opt
限る	（かぎ）る	to limit	manga, vocab_know, kanji_r
Xが分かれる	わかれる	X is split (Intr.) Cf. Xを分ける (Tr.)	manga, vocab_opt
優先	ゆうせん	priority	manga, vocab_know, kanji_r
片方	かたほう	＝一方; one side	manga, vocab_opt
意味がない	（いみ）がない	meaningless	manga, vocab_opt
そもそも		in the first place	manga, vocab_opt
近代化	きんだいか	modernization	manga, vocab_opt
道を進む	みちをすすむ	to go on a road	manga, vocab_opt
英国	えいこく	England	manga, vocab_opt
手本	てほん	model; example	manga, vocab_opt
一方的	いっぽうてき	one-sided	manga, vocab_opt
導入する	どうにゅう	to introduce; bring in	manga, vocab_opt
いつまでも		forever	manga, vocab_opt
議論	ぎろん	discussion	manga, vocab_know, kanji_r
それなら		if that’s the case; then	manga, vocab_opt
任期	にんき	term	manga, vocab_opt
短い	みじかい	short	manga, vocab_know, kanji_rw
国民	こくみん	people of the country; citizens	manga, vocab_know, kanji_rw
意思	いし	＝考え、意見	manga, vocab_opt
反映する	はんえい	to reflect	manga, vocab_opt
基本的な	きほんてき	basic	manga, vocab_know, kanji_r
中華	ちゅうか	Chinese food	manga, vocab_opt
ガツンと		vigorous remark (male slang)	manga, vocab_opt
油分	ゆぶん	oil content ＝油（あぶら）oil	manga, vocab_opt
控える	ひかえる	to restrain from excessiveness	manga, vocab_opt
話し合いの余地	はなしあいのよち	room for argument	manga, vocab_opt
政党	せいとう	political party	manga, vocab_know, kanji_r
遅刻	ちこく	to be late	manga, vocab_know
人込み	ひとごみ	crowd of people	manga, vocab_know, kanji_r
総理大臣	そうりだいじん	Prime Minister	manga, vocab_know, kanji_r
しゃべる		＝話す (spoken)	manga, vocab_opt
存在感	そんざいかん	feel of presence	manga, vocab_opt
それには		＝そのためには	manga, vocab_opt
党首	とうしゅ	party leader	manga, vocab_know, kanji_r
Xを目指す	めざす	to aim at X	manga, vocab_know, kanji_rw
親分	おやぶん	boss (yakuza)	manga, vocab_opt
政党政治	せいとうせいじ	party politics	manga, vocab_opt
Xが集まる	あつまる	X is gathered (Intr.) Cf. Xを集める (Tr.)	manga, vocab_opt, kanji_rw
中心	ちゅうしん	center	manga, vocab_know, kanji_rw
交わす	かわす	to exchange	manga, vocab_opt
Xを進める	すすめる	to advance; promote (Tr.) Cf. Xが進む(Intr.)	manga, vocab_know, kanji_rw
しくみ		＝制度; system	manga, vocab_opt
審議	しんぎ	＝議論; discussion	manga, vocab_opt
多数決	たすうけつ	majority voting	manga, vocab_opt
Xに所属する	しょぞく	to belong to X	manga, vocab_opt
発言権	はつげんけん	right of speaking	manga, vocab_opt
議席	ぎせき	legislative seat	manga, vocab_opt
過半数	かはんすう	＝半分以上; majority	manga, vocab_opt
確保する	かくほ	to secure	manga, vocab_opt
手を組む	てをくむ	to join hands	manga, vocab_opt
相手	あいて	other party	manga, vocab_opt
そのとおり		exactly	manga, vocab_opt
陣営	じんえい	administration	manga, vocab_opt
政権を握る	せいけんをにぎる	to hold the rights of government	manga, vocab_opt
計	けい	＝合計（ごうけい）; total	manga, vocab_opt
国会議員	こっかいぎいん	member of National Diet	manga, vocab_opt
解散	かいさん	break-up; dissolution	manga, vocab_know, kanji_r
選挙	せんきょ	election	manga, vocab_know, kanji_r
その時点で	そのじてんで	＝その時	manga, vocab_opt
各	かく	each	manga, vocab_opt
いったん		＝一度	manga, vocab_opt
仕切りなおす	しきりなおす	＝やりなおす	manga, vocab_opt
議席数	ぎせきすう	number of legislative seats	manga, vocab_opt
増	ぞう	=増える/増やす	manga, vocab_opt
狙う	ねらう	= to aim at (strategically)	manga, vocab_opt
（大）作戦	（だい）さくせん	tactics; strategy	manga, vocab_opt
公認	こうにん	=党が認める; officially recognized	manga, vocab_opt
候補者	こうほしゃ	candidate	manga, vocab_opt
新たに	あらたに	＝新しく	manga, vocab_opt
Xを争う	あらそう	to fight for	manga, vocab_opt
株	かぶ	stocks	manga, vocab_opt
取得する	しゅとく	＝取る	manga, vocab_opt
実権	じっけん	actual right to govern	manga, vocab_opt
Xをめぐる		concerning X (usually dispute)	manga, vocab_opt
陣取り合戦	じんとりがっせん	fight to occupy/secure  a place	manga, vocab_opt
本質	ほんしつ	essence	manga, vocab_opt
つかむ		to grasp; seize	manga, vocab_opt
感心する	かんしん	to be impressed	manga, vocab_know, kanji_rw
# For Kanji
政治	せいじ	politics	manga, vocab_know, kanji_rw